p,p,p,p,p,p,p,p,p,p
p,s,s,s,s,s,s,s,s,p
p,s,p,p,p,s,p,p,s,p
p,s,p,s,s,s,s,p,s,p
p,s,p,s,p,p,s,p,s,p
p,s,s,s,p,s,s,p,s,p
p,p,p,s,p,s,p,p,s,p
p,s,s,s,s,s,p,s,s,p
p,s,p,p,p,p,p,s,p,p
p,p,p,p,p,p,p,p,p,p